1  0  0  0  0  0  0  0  0  0  0  0  0  0  0  0  0  0  0  0  0  0  0  0  0  0  0  0  0  0  0  0  0  0  0  0  0  0  0  0  0  0  0  0  0  0  0  0  0  0  0  0  0  0  0  0  0  0  0  0  0  0  0  0  0  0  0  0  0  0  0  0  0  0  0  0  0  0  0  0  0  0  0  0  0  0  0  0  0  0  0  0  0  0  0  0  0  0  0  1
1  0  0  0  0  0  0  0  0  0  0  0  0  0  0  0  0  0  0  0  0  0  0  0  0  0  0  0  0  0  0  0  0  0  0  0  0  0  0  0  0  0  0  0  0  0  0  0  0  0  0  0  0  0  0  0  0  0  0  0  0  0  0  0  0  0  0  0  0  0  0  0  0  0  0  0  0  0  0  0  0  0  0  0  0  0  0  0  0  0  0  0  0  0  0  0  0  0  0  1
1  0  0  0  0  0  0  0  0  0  0  0  0  0  0  0  0  0  0  0  0  0  0  0  0  0  0  0  0  0  0  0  0  0  0  0  0  0  0  0  0  0  0  0  0  0  0  0  0  0  0  0  0  0  0  0  0  0  0  0  0  0  0  0  0  0  0  0  0  0  0  0  0  0  0  0  0  0  0  0  0  0  0  0  0  0  0  0  0  0  0  0  0  0  0  0  0  0  0  1
1  0  0  0  0  0  0  0  0  0  0  0  0  0  0  0  0  0  0  0  0  0  0  0  0  0  0  0  0  0  0  0  0  0  0  0  0  0  0  0  0  0  0  0  0  0  0  0  0  0  0  0  0  0  0  0  0  0  0  0  0  0  0  0  0  0  0  0  0  0  0  0  0  0  0  0  0  0  0  0  0  0  0  0  0  0  0  0  0  0  0  0  0  0  0  0  0  0  0  1
1  0  0  0  0  0  0  0  0  0  0  0  0  0  0  0  0  0  0  0  0  0  0  0  0  0  0  0  0  0  0  0  0  0  0  0  0  0  0  0  0  0  0  0  0  0  0  0  0  0  0  0  0  0  0  0  0  0  0  0  0  0  0  0  0  0  0  0  0  0  0  0  0  0  0  0  0  0  0  0  0  0  0  0  0  0  0  0  0  0  0  0  0  0  0  0  0  0  0  1
1  0  0  0  0  0  0  0  0  0  0  0  0  0  0  0  0  0  0  0  0  0  0  0  0  0  0  0  0  0  0  0  0  0  0  0  0  0  0  0  0  0  0  0  0  0  0  0  0  0  0  0  0  0  0  0  0  0  0  0  0  0  0  0  0  0  0  0  0  0  0  0  0  0  0  0  0  0  0  0  0  0  0  0  0  0  0  0  0  0  0  0  0  0  0  0  0  0  0  1
1  0  0  0  0  0  0  0  0  0  0  0  0  0  0  0  0  0  0  0  0  0  0  0  0  0  0  0  0  0  0  0  0  0  0  0  0  0  0  0  0  0  0  0  0  0  0  0  0  0  0  0  0  0  0  0  0  0  0  0  0  0  0  0  0  0  0  0  0  0  0  0  0  0  0  0  0  0  0  0  0  0  0  0  0  0  0  0  0  0  0  0  0  0  0  0  7  8  10 8
1  0  0  0  0  0  0  0  0  0  0  0  0  0  0  0  0  0  0  0  0  0  0  0  10 9  10 7  6  8  9  10 0  0  0  0  0  0  0  0  0  0  0  0  0  0  0  0  0  0  0  0  0  0  0  0  0  0  0  0  0  0  0  0  0  0  0  0  0  0  0  0  0  0  0  0  0  0  0  0  0  0  0  0  0  0  0  0  0  0  0  0  0  0  0  0  11 0  0  1
1  0  0  0  0  0  0  0  0  0  0  0  0  0  0  0  0  0  0  0  0  0  0  0  12 0  0  0  12 0  0  11 0  0  10 9  8  6  7  7  8  9  10 0  0  0  0  0  0  0  0  0  0  0  0  0  0  0  0  0  0  0  0  0  0  0  0  0  0  0  0  0  0  0  0  0  0  0  0  0  0  0  0  0  0  10 6  9  10 8  7  8  9  6  0  0  12 0  0  1
6  6  8  7  8  9  10 10 6  0  0  0  7  8  7  9  10 10 7  8  6  6  0  0  11 0  0  0  11 0  0  11 0  0  12 0  0  11 0  12 0  0  12 0  0  6  7  8  7  6  0  0  0  10 8  7  6  0  0  0  7  6  8  6  0  0  0  10 8  7  9  10 0  0  0  0  0  0  0  0  0  0  0  0  0  12 0  0  0  0  12 0  0  12 0  0  12 0  0  1
1  0  0  11 0  0  0  0  12 0  0  0  12 0  11 0  0  12 0  0  0  12 0  0  12 0  0  0  12 0  0  11 0  0  12 0  0  11 0  11 0  0  11 0  0  11 0  0  0  12 0  0  0  12 0  0  12 0  0  0  12 0  0  11 0  0  0  11 0  12 0  11 0  0  6  7  7  8  9  8  10 7  6  0  0  11 0  0  0  0  11 0  0  11 0  0  11 0  0  1
1  0  0  12 0  0  0  0  11 0  0  0  11 0  12 0  0  12 0  0  0  12 0  0  11 0  0  0  11 0  0  12 0  0  11 0  0  11 0  11 0  0  12 0  0  12 0  0  0  11 0  0  0  11 0  0  11 0  0  0  11 0  0  11 0  0  0  12 0  11 0  11 0  0  12 0  12 0  0  0  0  0  12 0  0  11 0  0  0  0  11 0  0  11 0  0  11 0  0  1
1  0  0  11 0  0  0  0  12 0  0  0  12 0  11 0  0  11 0  0  0  12 0  0  11 0  0  0  11 0  0  11 0  0  11 0  0  11 0  12 0  0  11 0  0  11 0  0  0  11 0  0  0  12 0  0  12 0  0  0  11 0  0  11 0  0  0  11 0  11 0  11 0  0  11 0  11 0  0  0  0  0  11 0  0  12 0  0  0  0  11 0  0  12 0  0  11 0  0  1
1  0  0  12 0  0  0  0  11 0  0  0  11 0  11 0  0  11 0  0  0  11 0  0  12 0  0  0  12 0  0  11 0  0  12 0  0  11 0  11 0  0  11 0  0  11 0  0  0  12 0  0  0  11 0  0  11 0  0  0  12 0  0  11 0  0  0  11 0  12 0  11 0  0  11 0  11 0  0  0  0  0  11 0  0  11 0  0  0  0  11 0  0  11 0  0  11 0  0  1
1  0  0  11 0  0  0  0  11 0  0  0  11 0  12 0  0  11 0  0  0  11 0  0  11 0  0  0  11 0  0  11 0  0  11 0  0  11 0  11 0  0  12 0  0  12 0  0  0  11 0  0  0  11 0  0  11 0  0  0  11 0  0  11 0  0  0  12 0  11 0  11 0  0  12 0  12 0  0  0  0  0  11 0  0  11 0  0  0  0  12 0  0  11 0  0  12 0  0  1
1  0  0  11 0  0  0  0  11 0  0  0  12 0  11 0  0  12 0  0  0  11 0  0  11 0  0  0  11 0  0  12 0  0  11 0  0  11 0  12 0  0  11 0  0  11 0  0  0  11 0  0  0  12 0  0  12 0  0  0  11 0  0  12 0  0  0  11 0  11 0  11 0  0  11 0  11 0  0  0  0  0  12 0  0  11 0  0  0  0  11 0  0  11 0  0  11 0  0  1
1  0  0  12 0  0  0  0  12 0  0  0  11 0  11 0  0  11 0  0  0  12 0  0  11 0  0  0  12 0  0  11 0  0  12 0  0  11 0  11 0  0  11 0  0  11 0  0  0  12 0  0  0  11 0  0  11 0  0  0  12 0  0  11 0  0  0  11 0  11 0  11 0  0  11 0  11 0  0  0  0  0  11 0  0  12 0  0  0  0  11 0  0  12 0  0  11 0  0  1
1  0  0  11 0  0  0  0  11 0  0  0  11 0  12 0  0  11 0  0  0  11 0  0  11 0  0  0  11 0  0  11 0  0  11 0  0  11 0  11 0  0  11 0  0  12 0  0  0  11 0  0  0  11 0  0  11 0  0  0  11 0  0  11 0  0  0  11 0  12 0  11 0  0  12 0  12 0  0  0  0  0  11 0  0  11 0  0  0  0  11 0  0  11 0  0  11 0  0  1
1  0  0  12 0  0  0  0  11 0  0  0  11 0  11 0  0  11 0  0  0  11 0  0  11 0  0  0  11 0  0  11 0  0  11 0  0  11 0  12 0  0  11 0  0  11 0  0  0  11 0  0  0  11 0  0  11 0  0  0  11 0  0  11 0  0  0  11 0  11 0  11 0  0  11 0  11 0  0  0  0  0  12 0  0  11 0  0  0  0  12 0  0  11 0  0  11 0  0  1
1  0  0  11 0  0  0  0  12 0  0  0  11 0  11 0  0  11 0  0  0  12 0  0  11 0  0  0  11 0  0  11 0  0  11 0  0  11 0  11 0  0  11 0  0  11 0  0  0  12 0  0  0  11 0  0  11 0  0  0  11 0  0  11 0  0  0  11 0  11 0  11 0  0  11 0  11 0  0  0  0  0  11 0  0  11 0  0  0  0  11 0  0  11 0  0  11 0  0  1