14 3  2  3  2  2  2  3  3  3  2  3  2  3  2  2  2  3  3  3  2  3  2  3  2  2  2  3  3  3  2  3  2  3  2  2  2  3  3  3  2  3  2  3  2  2  2  3  3  3  2  3  2  3  2  2  2  3  3  3  2  3  2  3  2  2  2  3  3  3  2  3  2  3  2  2  2  3  3  3  2  3  2  3  2  2  2  3  3  3  2  3  2  3  2  2  15 1  1  1
6  0  0  0  0  0  0  0  0  0  0  0  0  0  0  0  0  0  0  0  0  0  0  0  0  0  0  0  0  0  0  0  0  0  0  0  0  0  0  0  0  0  0  0  0  0  0  0  0  0  0  0  0  0  0  0  0  0  0  0  0  0  0  0  0  0  0  0  0  0  0  0  0  0  0  0  0  0  0  0  0  0  0  0  0  0  0  0  0  0  0  0  0  0  0  0  7  1  1  1
6  0  0  0  0  0  0  0  0  0  0  0  0  0  0  0  0  0  0  0  0  0  0  0  0  0  0  0  0  0  0  0  0  0  0  0  0  0  0  0  0  0  0  0  0  0  0  0  0  0  0  0  0  0  0  0  0  0  0  0  0  0  0  0  0  0  0  0  0  0  0  0  0  0  0  0  0  0  0  0  0  0  0  0  0  0  0  0  0  0  0  0  0  0  0  0  7  1  1  1
6  0  0  0  0  0  0  0  0  0  0  0  0  0  0  0  0  0  0  0  0  0  0  0  0  0  0  0  0  0  0  0  0  0  0  0  0  0  0  0  0  0  0  0  0  0  0  0  0  0  0  0  0  0  0  0  0  0  0  0  0  0  0  0  0  0  0  0  0  0  0  0  0  0  0  0  0  0  0  0  0  0  0  0  0  0  0  0  0  0  0  0  0  0  0  0  7  1  1  1
6  0  0  0  0  0  0  0  0  0  0  0  0  0  0  0  0  0  0  0  0  0  0  0  0  0  0  0  0  0  0  0  0  0  0  0  0  0  0  0  0  0  0  0  0  0  0  0  0  0  0  0  0  0  0  0  0  0  0  0  0  0  0  0  0  0  0  0  0  0  0  0  0  0  0  0  0  0  0  0  0  0  0  0  0  0  0  0  0  0  0  0  0  0  0  0  7  1  1  1
6  0  0  0  0  0  0  0  0  0  0  0  0  0  0  0  0  0  0  0  0  0  0  0  0  0  0  0  0  0  0  0  0  0  0  0  0  0  0  0  0  0  0  0  0  0  0  0  0  9  4  5  4  8  0  0  0  0  0  0  0  0  0  0  0  0  0  0  0  0  0  0  0  0  0  0  0  0  0  0  0  0  0  0  0  0  0  9  4  8  0  0  0  0  0  0  7  1  1  1
6  0  0  0  0  0  0  0  0  0  0  0  0  0  0  0  9  5  5  4  5  4  4  8  0  0  0  0  0  0  0  0  0  0  0  0  0  0  9  4  5  5  4  5  4  8  0  0  0  11 2  3  2  10 0  0  0  0  0  0  0  0  0  0  0  0  0  0  0  0  0  0  0  0  0  0  0  9  4  4  8  0  0  0  0  9  4  13 1  6  0  0  0  0  0  0  7  1  1  1
6  0  0  0  0  0  0  0  0  0  0  0  0  0  0  0  11 3  3  2  2  3  3  10 0  0  0  0  0  0  0  0  0  0  0  0  0  0  7  1  1  1  14 3  2  10 0  0  0  0  0  0  0  0  0  0  0  0  0  0  0  0  0  0  0  0  0  0  0  0  0  0  9  4  8  0  0  11 2  2  10 0  0  0  0  7  1  1  1  6  0  0  0  0  0  0  11 2  3  2
6  0  0  0  0  0  0  0  9  4  5  4  5  8  0  0  0  0  0  0  0  0  0  0  0  0  0  9  4  5  5  4  5  4  4  4  5  4  13 1  1  1  6  0  0  0  0  0  0  0  0  0  0  0  0  0  9  4  5  4  8  0  0  0  0  0  0  0  0  0  0  0  7  1  6  0  0  0  0  0  0  0  0  9  4  13 1  1  1  6  0  0  0  0  0  0  0  0  0  0
6  0  0  0  0  0  0  0  7  1  1  1  1  6  0  0  0  0  0  0  0  0  0  0  0  0  0  7  1  1  1  1  1  1  1  1  1  1  1  1  1  1  6  0  0  0  0  0  0  0  0  0  0  0  0  0  7  1  1  1  6  0  0  0  0  0  9  4  5  8  0  0  7  1  6  0  0  0  0  0  0  0  0  7  1  1  1  1  1  6  0  0  0  0  0  0  0  0  0  0
12 5  4  5  4  4  4  5  13 1  1  1  1  12 4  4  5  4  4  5  4  5  4  5  4  5  4  13 1  1  1  1  1  1  1  1  1  1  1  1  1  1  12 5  4  5  4  5  4  5  4  5  4  5  4  5  13 1  1  1  12 5  4  5  4  5  13 1  1  12 4  5  13 1  12 5  4  5  4  5  4  5  4  13 1  1  1  1  1  12 4  5  4  5  4  5  4  5  4  5
1  1  1  1  1  1  1  1  1  1  1  1  1  1  1  1  1  1  1  1  1  1  1  1  1  1  1  1  1  1  1  1  1  1  1  1  1  1  1  1  1  1  1  1  1  1  1  1  1  1  1  1  1  1  1  1  1  1  1  1  1  1  1  1  1  1  1  1  1  1  1  1  1  1  1  1  1  1  1  1  1  1  1  1  1  1  1  1  1  1  1  1  1  1  1  1  1  1  1  1