2 3 2 3 2 2 2 3 3 3
0 0 0 0 0 0 0 0 0 0
0 0 0 0 0 0 0 0 0 0
0 0 0 0 0 0 0 0 0 0
4 5 4 5 5 4 4 4 5 5
1 1 1 1 1 1 1 1 1 1